{
"101":"101",
"A102":"102",
"103":"103",
"104":"104",
"105 ok":"105",
"106":"106",	
"201":"201",
"202": "202",
"203": "203",
"204": "204",
"205": "205",
"206": "206",
"207": "207",
"301":"301",
"302":"302",
"303":"303",
"304":"304",
"305":"305",
"401":"401",
"402":"402",
"405":"405",
"406":"406",
"407":"407",
"408":"408",
"409":"409",
"410":"410",
"501":"501",
"502":"502"
}